the age of consent -- is 18
youre nevr -- getting this game
wow this is like -- base game or smth
schoolgrounds? -- more like smellgrounds
cockvict penor -- baaaaaaaaash
this is so -- kino and ng soul
whats a -- bacon burger
fuck flashfix -- i hate them
go pico -- yea yea
response to gackt -- cancelled mod
i dont own -- flash
im no scientist -- 
coded in base game -- just kidding
cancle fnf -- mid game
Ugh -- a school shooting joke?
they took -- the mf money
they spent money -- on crack
schizophrenic -- ginger kid
Sup -- Req make Sup
you're -- done
4chan -- fnf leak
we -- rise
thanks funkg -- very cool
guys do you think -- pico is gay
i ran out -- of ideas
Yo pico -- what's up ginger
give me -- mod perms
that boys -- a liar
is this -- pico school 2
picking up -- where Tom left off
Nene doesn't have herpes -- silly punkape
im killin -- this whole team
whats ng soul -- my parents left me
schoolgrounds does -- what nintendon't
haiiii hai hai -- haiah haiih haiiii :3
Conheci um f√£ que tipo -- Fala, fala, fala
like ddr -- but worst
schoolgrounds -- high quality rips when
piconjo -- loves joo
if i ever lived like you -- i'd cut my fuckin neck
kill -- yourself :3
i need -- you dead
Friday night shootin -- biggest inspiration
certified -- munch moment
for the unfiltered creatives -- with love from rojo
how do i -- refun my kickstarter money
rhythm gaming excellence -- my ass
for teh fnf losers -- from kiddo
xanax orange juice spill -- .gif